111111111111111111111111111
100000000000010000000000001
101111011111010111110111101
101111011111010111110111101
100000000000000000000000001
101111010111111111010111101
100000010000010000010000001
111111011111010111110111111
0000010100000B0000010100000
111111010111000111010111111
0000000001P00I00C1000000000
111111010111111111010111111
000001010000000000010100000
111111010111111111010111111
100000000000010000000000001
101111011111010111110111101
1001110000000U0000000111001
110111010111111111010111011
100000010000010000010000001
101111111111010111111111101
100000000000000000000000001
111111111111111111111111111