11111111111111111111111111111111
100000000000000U0000000000000001
11110111111111111111111111101111
00010100000000000000000000101000
00010111111111111111111111101000
111100000000001IB100000000001111
00000111111000000000111111000000
111100000000001PC100000000001111
00010111111111111111111111101000
00010100000000000000000000101000
11110111111111111111111111101111
10000000000000000000000000000001
11111111111111111111111111111111