111111111111111111111111111
1#***********1***********#1
1*1111*11111*1*11111*1111*1
1*1111*11111*1*11111*1111*1
1*************************1
1*1111*1*111111111*1*1111*1
1******1*****1*****1******1
111111*11111*1*11111*111111
000001*1*****B*****1*100000
111111*1*111000111*1*111111
*********1P00I00C1*********
111111*1*111000111*1*111111
000001*1***********1*100000
111111*1*111111111*1*111111
1************1************1
1*1111*11111*1*11111*1111*1
1**111*******U*******111**1
11*111*1*111111111*1*111*11
1******1*****1*****1******1
1*1111111111*1*1111111111*1
1#***********************#1
111111111111111111111111111