1111111111
1000000001
1011111101
1011011101
1010011101
1010111101
1010111001
1010111011
1000000011
1111111111